1111111111111111111111111111111111
1000000000000C00000000000010000001
1000000000000000000000000000000001
1000000000010000000000000000000001
1000000000000000110000000000000001
10000000C00000C0000000100000000001
1000C00000000000000000010000000001
1000000000000000000000000000P00001
10000000C00000C00000000000000000E1
1111111111111111111111111111111111
