1111111111111111111111111111111111111111111111111111111111111111111111111111111111111111111111111111
1E000000000000000000000000000000000000000000000000000000000000C0000000000000000000000000000000000001
10000000000000000000000000000000000000000000000000000000000000C0000000000000000000000000000000000001
10000000000000000000000000000000000000000000000000000000000000C0000000000000000000000000000000000001
1111111111111111111111111111111111111111111111111111111111111111111111111100111111111111111111111111
1111111111111111111111111111111111111111111111111111111111111111111111111110C11111111111111111111111
1111111111111111111111111111111111111111111111111111111111111111111111111111011111111111111111111111
1000000000000000000000000000000000000000000000000000000000000000000000000000000000000000000000000001
1000000000000000000000000000000000000000000000000000000000000000000000000000000000000000000000000001
1000000000000000000000000000000000000000000000000000000000000000000000000000000000000000000000000001
1000000000000000000000000000000000000000000000000000000000000000000000000000000000000000000000000001
1000000000000000000000000000000000000000000000000000000000000000000000000000000000000000000000000001
1000000000000000000000000000000000000000000000000000000000000000000000000000000000000000000000000001
1000000000000000000000000000000000000000000000000000000000000000000000000000000000000000000000000001
1000000000000000000000000000000000000000000000000000000000000000000000000000000000000000000000000001
1000000000000000000000000000000000000000000000000000000000000000000000000000000000000000000000000001
1CCCCCCCCCCCCC000000000000000000000000000000000000000000000000000000000000000000000000000000000000P1
1111111111111111111111111111111111111111111111111111111111111111111111111111111111111111111111111111