111111111111111111111
1EP00000C000000000001
10000000C000000000001
10000000C000000000001
10000000C000000000001
10000000C000000000001
10000000C000000000001
10000000C000000000001
10000000C000000000001
10000000C000000000001
10000000C000000000001
10000000C000000000001
10000000C000000000001
10000000C000000000001
10000000C000000000001
10000000C000000000001
10000000C000000000001
10000000C000000000001
10000000C000000000001
10000000C000000000001
10000000C000000000001
10000000C000000000001
10000000C000000000001
10000000C000000000001
10000000C000000000001
10000000C000000000001
10000000C000000000001
10000000C000000000001
10000000C000000000001
10000000C000000000001
10000000C000000000001
10000000C000000000001
10000000C000000000001
10000000C000000000001
10000000C000000000001
10000000C000000000001
10000000C000000000001
10000000C000000000001
10000000C000000000001
10000000C000000000001
10000000C000000000001
111111111111111111111