11111111111111111111111111
1011111100000C000000000001
101CCC10000000000000000001
10100000000000000000000001
111110111111111111100P0001
100000CCCCCCCC1000000000E1
11111111111111111111111111
