1111111111111111111111111111111111
1000000000000000000000000010000001
1000000000000000000000000000000001
1000000000010000000000000000000001
1000000000000000110000C00000000001
10000000000000000000001C0000000001
1000000000000000000000100000000001
1000000000000000000000000000P00001
10000000000000000000000000000000E1
1111111111111111111111111111111111
