1111111111111
1CN1000000C11
1C00011111001
1P0N1E0000001
1111111111111