1111111111111
1C0100000CC11
1000011111001
1P0010E000001
1111111111111