1111111111111111111111111111111111
1000000000000000000000000010000001
1000000000000000000000000000000001
1000000000010000000000000000000001
1000000000000000110000C0000000P001
10000000000000000000001C00000000E1
1111111111111111111111111111111111
