1111111111111
1C0100000CC11
1C00011111001
1PC010E000001
1111111111111